WWWW
WSSWWWWWWWWWWWWWWWWWWWWWWWWWW
WSSSSSSSSSSSSSSSSSSSSSSSSSSSW
WSSSSSSSSSSSSSSSSSSSSSSSSSSSW
WWWWWWWWSSWWWWWWWWWWWWWWWWSSW
BBBBBBWWSSWBBBBBBBBBBBBBBWSSW
BBBBBWSSSSSSWBBBBBBBBBBBBWSSW
BBBBWSSSSSSSSWBBBBBBBBBBBWSSW
BBBWSSSSSSSSSSWBBBBBBBBBBWSSW
BBWSSSSGSGSSSSSWBBBBBBBBBWSSW
BWSSSSGSSSGSSSSSWBBBBBBBBWSSW
BWSSSSGGGGGSSSSSWWWWWWWWWWSSW
BWSSSSSSSSSSSSSSSSSSSSSSSSSSW
BWSSSSSSSsSSSSSSSSSSSSSSSSSSW
BWSSSSSSSSSSSSSSWWWWWWWWWWSSW
BWSSSSSSSSSSSSSSWBBBBBBBBWSSW
BBWSSSSSSSSSSSSWBBBBBBBBBWSSW
BBBWSSSSSSSSSSWBBBBBBBBBBWSSW
BBBBWSSSSSSSSWBBBBBBBBBBBWSSW
BBBBBWSSSSSSWBBBBBBBBBBBBWSSW
BBBBBBWSSWWWWWWWWWWWWWWWWWSSW
BBBBBBWSSSSSSSSSSSSSSSSSSSSSW
BBBBBWSSSSSSSSSSSSSSSSsSSSSSW
BBBBBWWWWWWWWWWWWWWWWWWWWWWWW