SSSSSSSSSSSSSSSSSSSSSSSSSWWW
SWSSSSSWSWSWWWWWWWWWWWWWSWWW
SWSSSSSWSWSWWWWWSSSSSSSWSWWW
SWWWSWWWWWSWWWWWSWWWSWWWSWWW
SWSSSWSSSSSWWWWWSWSSSWSSSWWW
SWSWSWSWSWWWWWWWSWWWWWSWWWWW
SWSWSWSWSSSSSSSWSWSSSSSWWWWW
SWSWSWWWWWSSsSSWSWSSsSSWWWWW
SWSWSSSSSSSSSSSWSSSSSSSWWWWW
SWSWWWWWWWWWWWWWWWSSSSSWWWWW
SSSWSSSSSSSSSSSSSSSSSSSSSSSW
WWWWSWSWWWWWWWWWSWWWWWWWWWSW
WWWWSWSWWWWWWWWWSSSSSWWWWWSW
WWWWSWSWWWWWWWWWWWWWSWWWWWSW
sSSSSWSWWWWWWWWWWWWWSWWWWWSW
SWWWWWSWWWWWWWWWWWWWWWWWWWSW
SWSWSSSWWWWWSSSSSSSSSWSSSSSW
SWSWSWSWWWWWSWWWWWWWSWSWWWWW
SSSWSWSWSSSWSWWWWWWWSWSWSSSW
WWSWSWSWSsSWSWWWWWWWSWSWWWSW
SSSWSWSWSSSWSWSSSSSWSWSSSWSW
WWWWSWSWSSSWSWSSsSSWSWWWSWSW
WWWWSWSSSSSWSWSSSSSWSWWWSWSW
WWWWSWSWSSSWSWSSSSSWSWWWSWSW
SSSSSWSWSSSWSSSSSSSWSWWWSWSW
SSSSSWSWSsSWWWSSSSSWSWWWSWSW
SsSSSWSWSSSWSWSSSSSWSWWWSWSW
SSSSSWSWWWWWSWSSsSSWSWWWSWSW
SSSSSWSWSSSSSSSSSSSWSWWWSWSW
WWWWSWSWWWWWWWSSSSSWSWWWSWSW
WWWWSWSSSSSSSSSSSSSWSSSWSWSW
WWWWSWWWWWWWSWWWWWSWWWSWSWSW
WWWWSWSSSSSSSSSWSSSWSWSWSWSW
WWWWSWWWWWWWWWWWSWWWSWSWSWSW
WWWWSSSSSSSSSSSSSSSSSWSSSSSW
WWWWWWWWWWWWWWWWWWWWWWWWWWWW