WWWW
WSSWWWWWWWWWWWWWWWWWWWWWWWWWW
WSSSSSSSSSSSSSSSSSSSSSSSSSSSW
WSSSSSSSSSSSSSSSSSSSSSSSSSSSW
WWWWWWWWSSWWWWWWWWWWWWWWWWSSW
BBBBBBWWSSWBBBBBBBBBBBBBBWSSW
BBBBBWSSSSSSWBBBBBBBBBBBBWSSW
BBBBWSSSSSSSSWBBBBBBBBBBBWSSW
BBBWSSSSSSSSSSWBBBBBBBBBBWSSW
BBWSSSSSSSSSSSSWBBBBBBBBBWSSW
BWSSSSSSSSSSSSSSWBBBBBBBBWSSW
BWSSSSSSSSSSSSSSWWWWWWWWWWSSW
BWSSSSSSSSSSSSSSSSSSSSSSSSSSW
BWSSSSSSSsSSSSSSSSSSSSSSSSSSW
BWSSSSSSSSSSSSSSWWWWWWWWWWSSW
BWSSSSSSSSSSSSSSWBBBBBBBBWSSW
BBWSSSSSSSSSSSSWBBBBBBBBBWSSW
BBBWSSSSSSSSSSWBBBBBBBBBBWSSW
BBBBWSSSSSSSSWBBBBBBBBBBBWSSW
BBBBBWSSSSSSWBBBBBBBBBBBBWSSW
BBBBBBWSSWWWWWWWWWWWWWWWWWSSW
BBBBBBWSSSSSSSSSSSSSSSSSSSSSW
BBBBBWSSSSSSSSSSSSSSSSsSSSSSW
BBBBBWWWWWWWWWWWWWWWWWWWWWWWW