WWWWWWWSSWWWWWWW
WSSSSSSSSSSSSSSW
WSSSSSSSSSSSSSSW
WSSSSSSSSSSSSSSW
WSSSSSSSSSSSSSSW
WSSSSSSSSSSSSSSW
WSSSSSSSSSSSSSSW
SSSSSSSSSSSSSSSS
SSSSSSSSSSSSSSSS
WSSSSSSSSSSSSSSW
WSSSSSSSSSSSSSSW
WSSSSSSSSSSSSSSW
WSSSSSSSSSSSSSSW
WSSSSSSSSSSSSSSW
WSSSSSSSSSSSSSSW
WWWWWWWSSWWWWWWW