WWWWWWWSSWWWWWWW
WWWWWWWSSWWWWWWW
WWWWWWWSSWWWWWWW
WWWWWWWSSWWWWWWW
WWWWSSSSSSSSWWWW
WWWWSSSSSSSSWWWW
WWWWSSsSSSSSWWWW
SSSSSSSSSSSSSSSS
SSSSSSSSSSSSSSSS
WWWWSSSSSsSSWWWW
WWWWSSSSSSSSWWWW
WWWWSSSSSSSSWWWW
WWWWWWWSSWWWWWWW
WWWWWWWSSWWWWWWW
WWWWWWWSSWWWWWWW
WWWWWWWSSWWWWWWW