WWWWWWWSSWWWWWWW
WWWWWSSSSSSWWWWW
WWWSSSSSSSSSSWWW
WWSSSSSsSSSSSSWW
WWSSSSSSSSSSSSWW
WSSSSSGGGGSSSSSW
WSSSSGGGGGGSSSSW
SSSSSGGGGGGSSSSS
SSSSSGGGGGGSSSSS
WSSSSGGGGGGSSSSW
WSSSSSGGGGSSSSSW
WWSSSSSSSSSSSSWW
WWWSSSSSSSSSSWWW
WWWSSSSSSSSSSWWW
WWWWWSSSSSSWWWWW
WWWWWWWSSWWWWWWW