WWWWWWWSSWWWWWWW
WWWWWSSSSSSWWWWW
WWWSSSSSSSSSSWWW
WWSSSSSsSSSSSSWW
WWSSSSSSSSSSSSWW
WSSSSSSSSSSSSSSW
WSSSSSSSSSSSSSSW
SSSSSSSSSSSSSSSS
SSSSSSSSSSSSSSSS
WSSSSSSSSSSSSSSW
WSSSSSSSsSSSSSSW
WWSSSSSSSSSSSSWW
WWWSSSSSSSSSSWWW
WWWSSSSSSSSSSWWW
WWWWWSSSSSSWWWWW
WWWWWWWSSWWWWWWW