WWWWWWWSSWWWWWWW
WWWWWWWSSWWWWWWW
WWWWWWWSSWWWWWWW
WWWWWWWSSWWWWWWW
WWWWWWWSSWWWWWWW
WWWWWWWSSWWWWWWW
WWWWWWSSSSWWWWWW
SSSSSSSSSSSSSSSS
SSSSSSSsSSSSSSSS
WWWWWWSSSSWWWWWW
WWWWWWWSSWWWWWWW
WWWWWWWSSWWWWWWW
WWWWWWWSSWWWWWWW
WWWWWWWSSWWWWWWW
WWWWWWWSSWWWWWWW
WWWWWWWSSWWWWWWW