WWWWWWWSSWWWWWWW
WSSSSSWSSSSSSSSW
WSSSSSWSSSSSsSSW
WSSsSSWWWWWWWWWW
WSSSSSSSSSSSSSSW
WSSSSSWSSSSSSSSW
WWWWWWWWWWWSWWWW
SSSSSSSWSSSSSSSS
SSSSSSSWSSSSSSSS
WSSSSSSWSSSSSSSW
WSSSsSSWSSSsSSSW
WSSSSSSWSSSSSSSW
WSSSSSSWSSSSSSSW
WWWSWWWWSSSSSSSW
WSSSSSSSSSSSSSSW
WWWWWWWSSWWWWWWW